000000000000000000000000111111111111122221111000000000000000000011111111100000000000000000000000000000000000000000000000000000000000000000000000000000000000000000000
000000000000000000000000111111111111122221111000000000000000000011111111100000000000000000000000000000000000000000000000000000000000000000000000000000000000000000000
000001111111111111111111111111111111111111111111111111111111111111133333300000000000000000000000000000000000000000000000000000000000000000000000000000000000000000000
000001111111111111111111111111111111111111111111111111111111111111111221100000000000000000000000000000000000000000000000000000000000000000000000000000000000000000000
000001111111111111111111111111111111111111111111111111111111111111111111100000000000000000000000000000000000000000000000000000000000000000000000000000000000000000000
000004444444444333333333111111111111111111111000000000000000111111133333300000000000000000000000000000000000000000000000000000000000000000000000000000000000000000000
000004444444444222244433111111111111111111111000000000000000111111111111100000001111111111110000000000000000000000000000000000000000000000000000000000000000000000000
000004444444444222244433111111111111111111111000000000000000111111111111100000001111111111110000000000000000000000000000000000000000000000000000000000000000000000000
000004444444444444444433111111111111111111111000000000000000221111111111100000001111111111110000000000000000000000000000000000000000000000000000000000000000000000000
000004444444444444444433111111111111111111111000000000000000221111100000000000001111111111110000000000000000000000000000000000000000000000000000000000000000000000000
000004444444444444444433111111111111111111111000000000000000111111111111122211111111111111110000000000000000000000000000000000000000000000000000000000000000000000000
000004444444444444444433111111111111111111111000000000000000111111111111111111111111111111110000000000000000000000000000000000000000000000000000000000000000000000000
000004444444444444444433111111111111111111111000000000000000111111111111111111111111111111110000000000000000000000000000000000000000000000000000000000000000000000000
000004444444442222244433111111111111111111111000000000000000000000000000000000001111111111110000000000000000000000000000000000000000000000000000000000000000000000000
000004444444442222244433111111111111111111111000000000000000000000000000000000001111111111110000000000000000000000000000000000000000000000000000000000000000000000000
000001111111555533333333111111111111111111111111111111111111111111000000000011111111111111111111111111111111111111111111111111111111111111111111111111111111111111000
000001111111111133111111111111111111111111111111111111111111111111000000000011111111111111111111111111111111111111111111111111111111111111111111111111111111111111000
000001111111111133111111111111111111111111111111111111111111111111000000000011111111111111111111111111111111111111111111111111111111111111111111111111111111111111000
000001111111111133111111111111111111111111111111111111111111111111000000000011111111111111111111111111111111111111111111111111111111111111111111111111111111111111000
000002221111111133111111111111111111111111111111111111111111111111000000000011111111111111111111111111111111111111111111111111111111111111111111111111111111111111000
000002221111111332221111111111111111111111111111111111111111111111000000000011111111111111111111111111111111111111111111111111111111111111111111111111111111111111000
000002221111111332221111111111111111111111111111111111111111111111000000000011111111111111111111111111111111111111111111111111111111111111111111111111111111111111000
000001111111111133333333111111111111111111111111111111111111111111000000000011111111111111111111111111111111111111111111111111111111111111111111111111111111111111000
000001111111111111111100111111111111111111111111111111111111111111000000000011111111111111111111111111111111111111111111111111111111111111111111111111111111111111000
000001111111111111111100111111111111111111111111111111111111111111000000000011111111111111111111111111111111111111111111111111111111111111111111111111111111111111000
000001111111111111111100111111111111111111111111111111111111111111000000000011111111111111111111111110000000000000111111111111111111133333311111111111111111111111000
000001111111111111111100111111111111111111111111111111111111111111000000000011111111111111111111111110000000000000111111111111111111133333311111111111111111111111000
000001111111111111111100111111111111111111111111111111111111111111000000000011111111111111111111111110000000000000111111111111111111133333311111111111111111111111000
000001111111111111111100111111111111111111111111111111111111111111000000000011111111111111111111111110000000000000111111111111111111133333311111111111111111111111000
000001111111111111111100111111111111111111111111111111111111111111000000000011111111111111111111111110000000000000111111111111111111133333311111111111111111111111000
000000000000000000000000111111111111111111111111111111111111111111000000000011111111111111111111111110000000000000111111111111111111133333311111111111111111122222000
000000000000000000000000111111111111111111111111111111111111111111000000000011111111111111111111111110000000000000111111111111111111133333311111111111111111122222000
000001111111111111111111111111111111111111111111111111111111111111111111111111111111111111111111111110000000000000111111111111111111133333311111111111111111122222000
000001111111111111111111111111111111111111111111111111111111111111111111111111111111111111111111111110000000000000111111111111111111133333311111111111111111111111000
000001111111111111111111111111111111111111111111111111111111111111111111111111111111111111111111111110000000000000111111111111111111133333311111111111111111111111000
000001111111111111111111111111111111111111111111111111111111111111111111111111111111111111111111111110000000000000111111111111111111133333311111111111111111111111000
000001111111111111111111111111111111111111111111111111111111111111111111111111111111111111111111111110000000000000111111111111111111133333311111111111111111111111000
000001111111111111111111111111111111111111111111111111111111111111111111111111111111111111111111111111111111111111111111111111111111100000011111111111111111111111000
000001111111111111111111111111111111111111111111111111111111111111111111111111111111111111111111111111111111111111111111111111111111100000011111111111111111111111000
000001111111111111111111111111111111111111111111111111111111111111111111111111111111111111111111111111111111111111111111111111111111100000011111111111111111111111000
000001111111111111111111111111111111111111111111111111111111111111111111111111111111111111111111111111111111111111111111111111111111100000011111111111111111111111000
000000000000000011111111111111111111111111111111111111111111111111111111111111111111111111111111111111111111111111111111111111111111100000011111111111111111111111000
000000000000000011111111111111111111111111111111111111111111111111111111111111111111111111111111111111111111111111111111111111111111100000011111111111111111111111000
000000000000000011111111111111111111111111111111111111111111111111111111111111111111111111111111111111111111111111111111111111111111100000011111111111111111111111000
000000000000000011111111111111111111111111111111111111100000111111100000000000000000000000000000111111111111111111000000000000000000000000011111111111111111111111000
000000000000000011111111111111111111111111111111111111100000111111100000000000000000000000000000111111111111111111000000000000000000000000011111111111111111111111000
000000000000000011111111111111111111111111111111111111100000111111100000000000000000000000000000111111111111111111000000000000000000000000011111111111111111111111000
000000000000000011111111111111111111111111111111111111100000111111100000000000000000000000000000000000000000000000000000000000000000000000000000000111111111111111000
000000000000000011111111111111111111111111111111111111100000111111100000000000000000000000000000000000000000000000000000000000000000000000000000000111111111111111000
000000000000000011111111111111111111111111111111111111100000111111100000000000000000000000000000000000000000111111111111111111111111111111111111111111111111111111000
000000000000000011111111111111111111111111111111111111100000111111100000000000000000000000000000000000000001111111111111111111111111111111111111111111111111111111000
000000000000000011111111111111111111111111111111111111100000111111100000000000000000000000000000000000000000111111111111111111111111111111111111111111111111111111000
000000000000000011111111111111111111111111111111111111100000111111111111111111111111111000000000000000000000111111111111111111111111111111111111111111111111111111000
000000000000000011111111111111111111111111111111111111100000111111111111111111111111111000000000000000000000111111111111111111111111111111111111111111111111111111000
000000000000000011111111111111111111111111111111111111100000111111111111111111111111111000000000000000000000111111111111111111111111111111111111111111111111111111000
000000000000000011111111111111111111111111111111111111100000111111111111111111111111111000000000000000000000111111111111111111111111111111111111111111111111111111000
000000000000000011111111111111111111111111111111111111100000111111111111111111111111111000000000000000000000111111111111111111111111111111111111111111111111111111000
000000000000000011111111111111111111111111111111111111100000000000000000011111111111111000000000000000000000111111111111111111111111111111111111111111111111111111000
000000000000000011111111111111111111111111111111111111100000000000000000011111111111111000000000000000000000111111111111111111111111111111111111111111111111111111000
000000000000011111111111111111111111111111111111111111100000000000000000011111111111111000000000000000000000111111111111111111111111111111111111111111111111111111000
000000000000011111111111111111111111111111111111111111100000000000000000011111111111111000000000000000000000111111111111111111111111111111111111111111111111111111000
000000000000011111111111111111111111111111111111111111100000000000000000011111111111111000000000000011111111111111111111111111111111111111111111111111111111111111000
000000000000011111111111111111111111111111111111111111100000000000000000011111111111111000000000000011111111111111111111111111111111111111111111111111111111111111000
000000000000033311111111111111111111111111111111111111100000000000000000011111111111111000000000000011111111111111111111111111111111111111111111111111111111111111000
000004444444444444555111111111111111111111111111111111100000000000000000011111111111111000000000000011111111111111111111111111111111111111111111111111111111111111000
000004444444444444555111111111111111111111111111111111100000000000000000011111111111111000000000000011111111111111111111111111111111111111111111111111111111111111000
000004444444444444111111111111111111111111111111111111100000000000000000011111111111111000000000000011111111111111111111111111111111111111111111111111111111111111000
000004444444444444111111111111111111111111111111111111100000000000000000011111111111111111111110000011111111111111111111111111111111111111111111111111111111111111000
000004444444444444111111111111111111111111111111111111100000000000000000011111111111111111111110000011111111111111111111111111111111111111111111111111111111111111000
000004444222244444111111111111111111111111111111111111100000000000000000011111111111111111111110000011111111111111111111111111111111111111111111111111111111111111000
000004444222244444111111111111111111111111111111111111100000000000000000011111111111111111111110000011111111111111111111111111111111111111111111111111111111111111000
000004444222244444111111111111111111111111111111111111100000000000000000011111111111111111111110000011111111111111111111111111111111111111111111111111111111111111000
000004444444444444111111111111111111111111110000000000000000000000000000011111111111111111111110000011111111111111111111111111111111111111111111111111111111111111000
000004444444444444111111111111111111111111110000000000000000000000000000011111111111111111111111111111111111111111111111111111111111111111111111111111111111111111000
000004444444444444111111111111111111111111111111111111111100000000000000011111111111111111111111111111111111111111111111111111111111111111111111111111111111111111000
000002224444444444111111111111111111111111111111111111111100000000000000011111111111111111111111111111111111111111111111111111111111111111111111111111111111111111000
000002224444444444111111111111111111111111111111111111111111111111000000011111111111111111111111111111111111111111111111111111111111111111111111111111111111111111000
000001111111111111111111111111111111111111111111111111111111111111000000011111111111111111111111111111111111111111111111111111111111111111111111111111111111111111000
000001111111111111111112221111111111111111111111111111111111111111000000011111111111111000000000000011111111111111111111111111111111111111111111111111111111111111000
000001111111111111111112221111111111111111111111111111111111111111001111111111111111111000000000000011111111111111111111111111111111111111111111111111111111111111000
000003333333333333333333331111111111111111111111111111111111111111001111111111111111111000000000000011111111111111111111111111111111111111111111111111111111111111000
000003333333333333333333331111111111111111111111111111111111111111001111111111111111111000000000000011111111111111111111111111111111111111111111111111111111111111000
000001112222111111111221111111111111111111111111111111111111111111001111111111111111111000000000000011111111111111111111111111111111111111111111111111111111111111000
000001112222111111111221111111111111111111111111111111111111100000001111111111111111111000000000000011111111111111111111111111111111111111111111111111111111111111000
000001111111111111111111111111111111111111111111111111111111100000001111111111111111111000000000000011111111111111111111111111111111111111111111111111111111111111000
000001111111111111111111111111111111111111111111111111111111100000001111111111111111111000000000000011111111111111111111111111111111111111111111111111111111111111000
000001111111111111111111111111111111111111111111111111111111100000001111111111111111111000000000000011111111111111111111111111111111111111111111111111111111111111000
000001111111111111111111111111111111111111111111111111100000000000001111111111111111111000000000000011111111111111111111111111111111111111111111222222222111111111000
000001111111111111111111111111111111111111111111111111100000000000001111111111111111111000000000000011111111111111111111111111111111111111111111222222222111111111000
000001111111111111111111111111111111111111111111111111100000000000001111111111111111111000000000000011111111111111111111111111111111111111111111222222222111111111000
000001111111111111111111111111111111111111111111111111111111111111111111111111111111111000000000000011111111111111111111111111111111111111111111222222222111111111000
000001111111111111111111111111111111111111111111111111111111111111111111111111111111111000000000000011111111111111111111111111111111111111111111222222222111111111000
000001111111111111111111111111111111111111111111111111111111111111111111111111111111111111111111111111111111111111111111111111111111111111111111111111111111111111000
000001111111122222111111111111111111111111111111111110000000000000000000000000000000000000000000000011111111111111111111111111111111111111111111111111111111111111000
000001111111122222111111111122222222111111111111111110000000000000000000000000000000000000000000000011111111111111111111111111111111111111111111111111111111111111000
000001111111122222111111111122222222000011111111111110000000000000000000000000000000000000000000000011111111111111111111111111111111111111111111111111111111111111000
000000000000000000000000000000000000000000000000000000000000000000000000000000000000000000000000000000000000000000000000000000000000000000000000000000000000000000000
000000000000000000000000000000000000000000000000000000000000000000000000000000000000000000000000000000000000000000000000000000000000000000000000000000000000000000000
000000000000000000000000000000000000000000000000000000000000000000000000000000000000000000000000000000000000000000000000000000000000000000000000000000000000000000000
000000000000000000000000000000000000000000000000000000000000000000000000000000000000000000000000000000000000000000000000000000000000000000000000000000000000000000000
000000000000000000000000000000000000000000000000000000000000000000000000000000000000000000000000000000000000000000000000000000000000000000000000000000000000000000000
000000000000000000000000000000000000000000000000000000000000000000000000000000000000000000000000000000000000000000000000000000000000000000000000000000000000000000000
000000000000000000000000000000000000000000000000000000000000000000000000000000000000000000000000000000000000000000000000000000000000000000000000000000000000000000000
000000000000000000000000000000000000000000000000000000000000000000000000000000000000000000000000000000000000000000000000000000000000000000000000000000000000000000000
000000000000000000000000000000000000000000000000000000000000000000000000000000000000000000000000000000000000000000000000000000000000000000000000000000000000000000000
