00000000000000000000000011111111111112222111100000000000000000001111111110000000000000000000000000000000000000000000000000000000000000000000000000000000000000000000000
00000000000000000000000011111111111112222111100000000000000000001111111110000000000000000000000000000000000000000000000000000000000000000000000000000000000000000000000
00000111111111111111111111111111111111111111111111111111111111111113333330000000000000000000000000000000000000000000000000000000000000000000000000000000000000000000000
00000111111111111111111111111111111111111111111111111111111111111111122110000000000000000000000000000000000000000000000000000000000000000000000000000000000000000000000
00000111111111111111111111111111111111111111111111111111111111111111111110000000000000000000000000000000000000000000000000000000000000000000000000000000000000000000000
00000444444444433333333311111111111111111111100000000000000011111113333330000000000000000000000000000000000000000000000000000000000000000000000000000000000000000000000
00000444444444422224443311111111111111111111100000000000000011111111111110000000111111111111000000000000000000000000000000000000000000000000000000000000000000000000000
00000444444444422224443311111111111111111111100000000000000011111111111110000000111111111111000000000000000000000000000000000000000000000000000000000000000000000000000
00000444444444444444443311111111111111111111100000000000000022111111111110000000111111111111000000000000000000000000000000000000000000000000000000000000000000000000000
00000444444444444444443311111111111111111111100000000000000022111110000000000000111111111111000000000000000000000000000000000000000000000000000000000000000000000000000
00000444444444444444443311111111111111111111100000000000000011111111111112221111111111111111000000000000000000000000000000000000000000000000000000000000000000000000000
00000444444444444444443311111111111111111111100000000000000011111111111111111111111111111111000000000000000000000000000000000000000000000000000000000000000000000000000
00000444444444444444443311111111111111111111100000000000000011111111111111111111111111111111000000000000000000000000000000000000000000000000000000000000000000000000000
00000444444444222224443311111111111111111111100000000000000000000000000000000000111111111111000000000000000000000000000000000000000000000000000000000000000000000000000
00000444444444222224443311111111111111111111100000000000000000000000000000000000111111111111000000000000000000000000000000000000000000000000000000000000000000000000000
00000111111155553333333311111111111111111111111111111111111111111100000000001111111111111111111111111111111111111111111111111111111111111111111111111111111111111100000
00000111111155553333333311111111111111111111111111111111111111111100000000001111111111111111111111111111111111111111111111111111111111111111111111111111111111111100000
00000111111111113311111111111111111111111111111111111111111111111100000000001111111111111111111111111111111111111111111111111111111111111111111111111111111111111100000
00000111111111113311111111111111111111111111111111111111111111111100000000001111111111111111111111111111111111111111111111111111111111111111111111111111111111111100000
00000111111111113311111111111111111111111111111111111111111111111100000000001111111111111111111111111111111111111111111111111111111111111111111111111111111111111100000
00000222111111113311111111111111111111111111111111111111111111111100000000001111111111111111111111111111111111111111111111111111111111111111111111111111111111111100000
00000222111111133222111111111111111111111111111111111111111111111100000000001111111111111111111111111111111111111111111111111111111111111111111111111111111111111100000
00000222111111133222111111111111111111111111111111111111111111111100000000001111111111111111111111111111111111111111111111111111111111111111111111111111111111111100000
00000111111111113333333311111111111111111111111111111111111111111100000000001111111111111111111111111111111111111111111111111111111111111111111111111111111111111100000
00000111111111111111110011111111111111111111111111111111111111111100000000001111111111111111111111111111111111111111111111111111111111111111111111111111111111111100000
00000111111111111111110011111111111111111111111111111111111111111100000000001111111111111111111111111111111111111111111111111111111111111111111111111111111111111100000
00000111111111111111110011111111111111111111111111111111111111111100000000001111111111111111111111111000000000000011111111111111111113333331111111111111111111111100000
00000111111111111111110011111111111111111111111111111111111111111100000000001111111111111111111111111000000000000011111111111111111113333331111111111111111111111100000
00000111111111111111110011111111111111111111111111111111111111111100000000001111111111111111111111111000000000000011111111111111111113333331111111111111111111111100000
00000111111111111111110011111111111111111111111111111111111111111100000000001111111111111111111111111000000000000011111111111111111113333331111111111111111111111100000
00000111111111111111110011111111111111111111111111111111111111111100000000001111111111111111111111111000000000000011111111111111111113333331111111111111111111111100000
00000000000000000000000011111111111111111111111111111111111111111100000000001111111111111111111111111000000000000011111111111111111113333331111111111111111112222200000
00000000000000000000000011111111111111111111111111111111111111111100000000001111111111111111111111111000000000000011111111111111111113333331111111111111111112222200000
00000111111111111111111111111111111111111111111111111111111111111111111111111111111111111111111111111000000000000011111111111111111113333331111111111111111112222200000
00000111111111111111111111111111111111111111111111111111111111111111111111111111111111111111111111111000000000000011111111111111111113333331111111111111111111111100000
00000111111111111111111111111111111111111111111111111111111111111111111111111111111111111111111111111000000000000011111111111111111113333331111111111111111111111100000
00000111111111111111111111111111111111111111111111111111111111111111111111111111111111111111111111111000000000000011111111111111111113333331111111111111111111111100000
00000111111111111111111111111111111111111111111111111111111111111111111111111111111111111111111111111000000000000011111111111111111113333331111111111111111111111100000
00000111111111111111111111111111111111111111111111111111111111111111111111111111111111111111111111111111111111111111111111111111111110000001111111111111111111111100000
00000111111111111111111111111111111111111111111111111111111111111111111111111111111111111111111111111111111111111111111111111111111110000001111111111111111111111100000
00000111111111111111111111111111111111111111111111111111111111111111111111111111111111111111111111111111111111111111111111111111111110000001111111111111111111111100000
00000111111111111111111111111111111111111111111111111111111111111111111111111111111111111111111111111111111111111111111111111111111110000001111111111111111111111100000
00000000000000001111111111111111111111111111111111111111111111111111111111111111111111111111111111111111111111111111111111111111111110000001111111111111111111111100000
00000000000000001111111111111111111111111111111111111111111111111111111111111111111111111111111111111111111111111111111111111111111110000001111111111111111111111100000
00000000000000001111111111111111111111111111111111111111111111111111111111111111111111111111111111111111111111111111111111111111111110000001111111111111111111111100000
00000000000000001111111111111111111111111111111111111110000011111110000000000000000000000000000011111111111111111100000000000000000000000001111111111111111111111100000
00000000000000001111111111111111111111111111111111111110000011111110000000000000000000000000000011111111111111111100000000000000000000000001111111111111111111111100000
00000000000000001111111111111111111111111111111111111110000011111110000000000000000000000000000011111111111111111100000000000000000000000001111111111111111111111100000
00000000000000001111111111111111111111111111111111111110000011111110000000000000000000000000000000000000000000000000000000000000000000000000000000011111111111111100000
00000000000000001111111111111111111111111111111111111110000011111110000000000000000000000000000000000000000000000000000000000000000000000000000000011111111111111100000
00000000000000001111111111111111111111111111111111111110000011111110000000000000000000000000000000000000000011111111111111111111111111111111111111111111111111111100000
00000000000000001111111111111111111111111111111111111110000011111110000000000000000000000000000000000000000111111111111111111111111111111111111111111111111111111100000
00000000000000001111111111111111111111111111111111111110000011111110000000000000000000000000000000000000000011111111111111111111111111111111111111111111111111111100000
00000000000000001111111111111111111111111111111111111110000011111111111111111111111111100000000000000000000011111111111111111111111111111111111111111111111111111100000
00000000000000001111111111111111111111111111111111111110000011111111111111111111111111100000000000000000000011111111111111111111111111111111111111111111111111111100000
00000000000000001111111111111111111111111111111111111110000011111111111111111111111111100000000000000000000011111111111111111111111111111111111111111111111111111100000
00000000000000001111111111111111111111111111111111111110000011111111111111111111111111100000000000000000000011111111111111111111111111111111111111111111111111111100000
00000000000000001111111111111111111111111111111111111110000011111111111111111111111111100000000000000000000011111111111111111111111111111111111111111111111111111100000
00000000000000001111111111111111111111111111111111111110000000000000000001111111111111100000000000000000000011111111111111111111111111111111111111111111111111111100000
00000000000000001111111111111111111111111111111111111110000000000000000001111111111111100000000000000000000011111111111111111111111111111111111111111111111111111100000
00000000000001111111111111111111111111111111111111111110000000000000000001111111111111100000000000000000000011111111111111111111111111111111111111111111111111111100000
00000000000001111111111111111111111111111111111111111110000000000000000001111111111111100000000000000000000011111111111111111111111111111111111111111111111111111100000
00000000000001111111111111111111111111111111111111111110000000000000000001111111111111100000000000001111111111111111111111111111111111111111111111111111111111111100000
00000000000001111111111111111111111111111111111111111110000000000000000001111111111111100000000000001111111111111111111111111111111111111111111111111111111111111100000
00000000000003331111111111111111111111111111111111111110000000000000000001111111111111100000000000001111111111111111111111111111111111111111111111111111111111111100000
00000444444444444455511111111111111111111111111111111110000000000000000001111111111111100000000000001111111111111111111111111111111111111111111111111111111111111100000
00000444444444444455511111111111111111111111111111111110000000000000000001111111111111100000000000001111111111111111111111111111111111111111111111111111111111111100000
00000444444444444411111111111111111111111111111111111110000000000000000001111111111111100000000000001111111111111111111111111111111111111111111111111111111111111100000
00000444444444444411111111111111111111111111111111111110000000000000000001111111111111111111111000001111111111111111111111111111111111111111111111111111111111111100000
00000444444444444411111111111111111111111111111111111110000000000000000001111111111111111111111000001111111111111111111111111111111111111111111111111111111111111100000
00000444422224444411111111111111111111111111111111111110000000000000000001111111111111111111111000001111111111111111111111111111111111111111111111111111111111111100000
00000444422224444411111111111111111111111111111111111110000000000000000001111111111111111111111000001111111111111111111111111111111111111111111111111111111111111100000
00000444422224444411111111111111111111111111111111111110000000000000000001111111111111111111111000001111111111111111111111111111111111111111111111111111111111111100000
00000444444444444411111111111111111111111111000000000000000000000000000001111111111111111111111000001111111111111111111111111111111111111111111111111111111111111100000
00000444444444444411111111111111111111111111000000000000000000000000000001111111111111111111111111111111111111111111111111111111111111111111111111111111111111111100000
00000444444444444411111111111111111111111111111111111111110000000000000001111111111111111111111111111111111111111111111111111111111111111111111111111111111111111100000
00000222444444444411111111111111111111111111111111111111110000000000000001111111111111111111111111111111111111111111111111111111111111111111111111111111111111111100000
00000222444444444411111111111111111111111111111111111111111111111100000001111111111111111111111111111111111111111111111111111111111111111111111111111111111111111100000
00000111111111111111111111111111111111111111111111111111111111111100000001111111111111111111111111111111111111111111111111111111111111111111111111111111111111111100000
00000111111111111111111222111111111111111111111111111111111111111100000001111111111111100000000000001111111111111111111111111111111111111111111111111111111111111100000
00000111111111111111111222111111111111111111111111111111111111111100111111111111111111100000000000001111111111111111111111111111111111111111111111111111111111111100000
00000333333333333333333333111111111111111111111111111111111111111100111111111111111111100000000000001111111111111111111111111111111111111111111111111111111111111100000
00000333333333333333333333111111111111111111111111111111111111111100111111111111111111100000000000001111111111111111111111111111111111111111111111111111111111111100000
00000111222211111111122111111111111111111111111111111111111111111100111111111111111111100000000000001111111111111111111111111111111111111111111111111111111111111100000
00000111222211111111122111111111111111111111111111111111111110000000111111111111111111100000000000001111111111111111111111111111111111111111111111111111111111111100000
00000111111111111111111111111111111111111111111111111111111110000000111111111111111111100000000000001111111111111111111111111111111111111111111111111111111111111100000
00000111111111111111111111111111111111111111111111111111111110000000111111111111111111100000000000001111111111111111111111111111111111111111111111111111111111111100000
00000111111111111111111111111111111111111111111111111111111110000000111111111111111111100000000000001111111111111111111111111111111111111111111111111111111111111100000
00000111111111111111111111111111111111111111111111111110000000000000111111111111111111100000000000001111111111111111111111111111111111111111111122222222211111111100000
00000111111111111111111111111111111111111111111111111110000000000000111111111111111111100000000000001111111111111111111111111111111111111111111122222222211111111100000
00000111111111111111111111111111111111111111111111111110000000000000111111111111111111100000000000001111111111111111111111111111111111111111111122222222211111111100000
00000111111111111111111111111111111111111111111111111111111111111111111111111111111111100000000000001111111111111111111111111111111111111111111122222222211111111100000
00000111111111111111111111111111111111111111111111111111111111111111111111111111111111100000000000001111111111111111111111111111111111111111111122222222211111111100000
00000111111111111111111111111111111111111111111111111111111111111111111111111111111111111111111111111111111111111111111111111111111111111111111111111111111111111100000
00000111111112222211111111111111111111111111111111111000000000000000000000000000000000000000000000001111111111111111111111111111111111111111111111111111111111111100000
00000111111112222211111111112222222211111111111111111000000000000000000000000000000000000000000000001111111111111111111111111111111111111111111111111111111111111100000
00000111111112222211111111112222222200001111111111111000000000000000000000000000000000000000000000001111111111111111111111111111111111111111111111111111111111111100000
00000000000000000000000000000000000000000000000000000000000000000000000000000000000000000000000000000000000000000000000000000000000000000000000000000000000000000000000
00000000000000000000000000000000000000000000000000000000000000000000000000000000000000000000000000000000000000000000000000000000000000000000000000000000000000000000000
00000000000000000000000000000000000000000000000000000000000000000000000000000000000000000000000000000000000000000000000000000000000000000000000000000000000000000000000
00000000000000000000000000000000000000000000000000000000000000000000000000000000000000000000000000000000000000000000000000000000000000000000000000000000000000000000000
00000000000000000000000000000000000000000000000000000000000000000000000000000000000000000000000000000000000000000000000000000000000000000000000000000000000000000000000
00000000000000000000000000000000000000000000000000000000000000000000000000000000000000000000000000000000000000000000000000000000000000000000000000000000000000000000000
00000000000000000000000000000000000000000000000000000000000000000000000000000000000000000000000000000000000000000000000000000000000000000000000000000000000000000000000
00000000000000000000000000000000000000000000000000000000000000000000000000000000000000000000000000000000000000000000000000000000000000000000000000000000000000000000000
